+-+---+---+---+---+
|y|   |   |   |   |
| | | | | | | |   |
| | | | | | | | | |
|   |   |   |   |e|
+---+---+---+---+-+