+-+---+---+---+---+
|y    |   |   |   |
| |-| | |-| | |   |
| |-| | |-| | | | |
|           |   |e|
+---+---+---+---+-+