+-+---+---+---+---+
y     |   |   |   |
| |-| | |-| | |   |
| |-| | |-| | | | |
|           |   | |
+---+---+---+---+e+
